110000220
011002220
001100000
000110000
220011000
020001111